                                                                                 eeeeeeeee
    xx333333333333333333333333333333333333333333333333333333333333333333333333333e       e
    xx||||||||||||||||||||||||||||||||||||||| |||||||||||||||||||||||||||||||||||        e
    x ---------------------------------------------------------------------------        e
    xs---------------------------------------------------------------------------        e
    xx|||||||||||||||||||||||||||||||||||||||||||||||||||||||||||||||||||||||||||        e
    xx333333333333333333333333333333333333333333333333333333333333333333333333333e       e
                                                                                 eeeeeeeee